############
#          #
# *  *O    #
# O        #
#          #
# %  *O    #
# *        #
#          #
#      &   #
#          #
#      *O  #
############
