############
#&         #
#          #
#          #
#          #
#          #
#     *    #
#          #
#         #
#          #
#      O   #
############
