##################################
#                &               #
#****************       *********#
#OOOOOOOOOOOOOOOO       OOOOOOOOO#
################# ################
################# ################
################# ################
################# ################
#############O*       *O##########
##################################

title: test a large level (32x8) with lots of boxes
