############
#&         #
#          #
#          #
#          #
#          #
#          #
#          #
#          #
#          #
#          #
############
