############
#&         #
#          #
#          #
#          #
#          #
#     *    #
#          #
#          #
#          #
#   #  O   #
#### #######
