########
###OO###
### O###
##  *O##
## *  ##
#  #** #
#  &   #
########

moves: 56
path: LUURRUULDLDDDRRUUDDRRULDLLLUURRURDLLLDDRRUURULDDDRUULLUU
