########
###O####
### ####
###* *O#
#O *&###
####*###
####O###
########

moves required: 10
