##################################
#   ##  #                        #
# # * * # ###################### #
#  @O#  # #          ##    ##### #
## #O&O## ########## ##    ##### #
##*###@##                    #   #
#        ##################### ###
#   ## #                       *O#
######   #########################
##################################

title: test a large level (32x8) with 193 moves (depth 49)
