##################################
#                &               #
#************                    #
#OOOOOOOOOOOO                    #
################# ################
################# ################
################# ################
################# ################
#############           ##########
##################################

title: test a large level (32x8) with 12 boxes
comment: this is generally the most boxes this program can handle
