##########
###   #O #
###  *OOO#
##  * #@O#
## ##*# ##
#   *  * #
#   #    #
#######& #
##########


moves required = ?