##########
###    ###
### *    #
### * ## #
#OOO *   #
#OOO*#* ##
#### # * #
####  &  #
##########

moves required = ?