###########
#### OOO###
####OOOO###
#  ###* ###
# * *  ** #
#& * *    #
#   ###   #
###########

moves required = ?