########
##    ##
# * ** #
#OOOOOO#
# ** * #
##  & ##
########

moves required: 31
solution: RULURLDDLLURDRULULRUURRDLULDULD
