##########
#   ##  ##
# # * * ##
#  @O#  ##
## #O&O###
##*###@###
#        #
#   ## # #
######   #
##########

title: a hard level
