##########
#&   *  O#
#    *  O#
#    *  O#
#    *  O#
##########


a harder level
solvable in 27

RRRRLDRLDRLDRRRLLURRLLURRLLURR